1 1 1 1 1 1 1 1 1 1
1 0 0 0 0 0 0 0 0 1
1 0 3 0 2 0 0 4-2-2 0 1
1 0 0 0 0 0 0 0 0 1
1 0 0 5-3-3 0 0 0 0 1
1 0 0 0 0 0 0 0 0 1
1 1 1 1 1 1 1 1 1 1
