1 1 1 1 1 1 1 1 1 1 1 1 1 1 1 1 1 1 1 1 1 1 1 1 1 1 1 1 1 1
1 0 3 0 1 1 0 0 0 0 0 0 0 0 0 0 0 0 0 0 0 0 0 0 0 9 0 0 0 1
1 0 0 0 1 1 0 0 0 0 0 0 0 0 0 0 0 0 0 0 0 0 0 0 0 0 0 0 0 1
1 0 0 0 1 1 0 0 2 0 0 0 0 0 0 0 0 0 0 0 0 0 0 0 0 0 0 0 0 1
1 0 0 0 1 1 0 0 0 0 0 0 0 1 1 0 0 0 0 0 0 0 0 0 0 0 0 0 10-2 1
1 0 0 0 1 1 0 0 0 0 0 0 0 1 1 0 0 0 0 0 0 0 0 0 0 0 0 0 10-2 1
1 0 0 0 1 1 0 0 0 0 0 0 10-2 1 1 0 0 0 0 0 0 0 0 0 1 1 1 1 1 1
1 0 0 0 1 1 0 0 0 0 0 0 10-2 1 1 0 0 0 0 0 0 0 0 0 1 1 1 1 1 1
1 0 0 0 1 1 0 0 0 0 0 0 10-2 1 1 0 8-1-1 0 1 1 0 0 0 0 0 0 0 0 0 1
1 0 0 0 1 1 10-1 0 0 0 0 1 1 1 1 0 0 0 1 1 10-1 0 0 0 0 0 0 0 0 1
1 0 0 0 1 1 10-1 0 0 0 0 1 1 1 1 0 2 0 1 1 0 0 0 0 0 0 0 0 0 1
1 0 4-1-1 0 1 1 0 0 6 0 0 1 1 1 1 0 0 0 1 1 1 1 0 0 0 0 0 0 0 1
1 0 0 0 1 1 1 1 1 1 1 1 1 1 1 0 4-1-1 0 1 1 1 1 0 0 0 0 0 0 0 1
1 0 8-1-1 0 1 1 1 1 1 1 1 1 1 1 1 0 0 0 0 0 0 0 0 0 0 0 0 0 0 1
1 0 0 0 0 0 0 0 0 0 0 0 0 1 1 0 0 0 0 0 0 0 0 0 0 0 0 0 0 1
1 0 0 0 0 0 0 0 0 0 0 0 0 1 1 0 0 0 0 0 0 0 0 0 0 0 0 0 0 1
1 0 0 0 0 0 4-4-4 0 0 0 0 0 0 1 1 0 0 0 0 0 0 0 0 0 0 0 0 0 0 1
1 0 0 0 0 0 0 0 0 0 0 0 0 1 1 0 0 0 0 0 0 0 0 0 0 0 0 0 0 1
1 0 0 0 0 0 0 0 0 0 0 0 0 1 1 0 0 0 0 0 0 0 0 0 0 0 0 0 0 1
1 0 0 0 0 0 1 1 0 0 1 1 1 1 1 0 0 0 0 0 0 0 0 0 0 0 0 0 0 1
1 0 0 0 0 0 1 1 0 0 1 1 1 1 1 0 0 1 0 0 0 0 0 1 1 1 1 1 1 1
1 0 0 0 0 2 1 1 0 0 1 1 0 0 4-2-2 0 0 1 0 0 0 0 0 1 1 1 1 1 1 1
1 0 0 0 1 1 1 1 0 0 1 1 0 2 0 0 0 1 0 0 0 0 0 1 1 1 1 1 1 1
1 0 0 0 1 1 1 1 0 0 1 1 0 0 0 0 0 1 0 0 0 0 0 1 1 1 1 1 1 1
1 0 0 0 1 1 1 1 0 0 1 1 1 1 1 1 1 1 0 0 0 0 0 0 0 0 0 0 0 1
1 0 0 0 1 1 0 0 0 0 0 0 1 1 1 1 1 1 0 0 0 0 0 0 0 0 0 0 0 1
1 0 0 0 1 1 0 0 0 0 0 0 1 1 0 0 0 0 0 0 0 0 0 0 0 0 0 0 0 1
1 0 0 0 1 1 10-1 0 0 0 0 0 1 1 0 0 0 0 0 0 0 0 0 0 0 0 0 0 0 1
1 0 0 0 1 1 0 0 0 0 0 10-2 1 1 0 0 0 1 1 1 1 1 10-1 0 0 0 0 0 0 1
1 0 0 0 1 1 0 0 0 2 0 0 1 1 0 0 0 1 1 1 1 1 10-1 0 0 0 0 0 0 1
1 0 0 0 1 1 1 1 1 1 1 1 1 1 0 0 0 1 1 0 0 0 0 0 0 0 0 0 0 1
1 0 0 0 0 0 0 0 0 0 0 0 0 0 0 0 0 1 1 0 2 0 0 0 0 0 1 1 1 1
1 0 2 0 0 0 0 0 0 0 0 0 0 0 0 0 0 1 1 0 0 0 0 0 0 0 1 1 1 1
1 0 0 0 0 0 0 0 0 0 0 0 0 0 0 0 0 1 1 0 0 0 0 0 0 0 1 1 1 1
1 1 1 1 1 1 1 1 1 1 1 1 1 1 1 1 1 1 1 1 1 1 1 1 1 1 1 1 1 1